Абсолютный - совершенный
Абстрактный - отвлеченный
Аграрный - земледельческий
Адекватный - соответствующий
Активный - деятельный
Актуальный - злободневный
Аморальный - безнравственный
Анализ - разбор
Антураж - окружение
Аргумент - довод
Бизнес - дело
Бойфренд - приятель
Брифинг - летучка
Вариант - разновидность
Габариты - размеры
Герметичный - непроницаемый
Гипотетический - предположительный
Голкипер - вратарь
Гуманность - человечность
Дайвер - ныряльщик
Дайджест - обзор
Дебаты - прения
Девальвация - обесценивание
Демонстрация - показ
Деструктивный - разрушительный
Детальный - подробный
Диалог - беседа
Директор - управляющий
Дискомфорт - неудобство
Дискуссия - обсуждение, спор
Дифференциация - разделение
Доминировать - господствовать, преобладать
Дуэль - поединок
Игнорировать - пренебрегать
Идентичный - тождественный
Имидж - образ
Импорт - ввоз
Индивидуальный - единоличный
Индифферентный - безразличный
Индустрия - промышленность
Инертный - равнодушный
Интервенция - вторжение
Интернациональный - международный
Инфицированный - зараженный